vertices_num,percentage_max_num_edges,exhaustive_total_weight,greedy_total_weight,weight_difference,exhaustive_execution_time,greedy_execution_time,time_ratio,exhaustive_num_operations,greedy_num_operations
4,0.125,66,66,0,0.002219676971435547,0.0008146762847900391,0.3670247046186896,1,1
4,0.25,52,52,0,0.001157522201538086,0.001131296157836914,0.9773429454170958,2,2
4,0.5,87,168,-81,0.0012731552124023438,0.0010273456573486328,0.8069288389513108,1,2
4,0.75,69,90,-21,0.003640413284301758,0.0011658668518066406,0.32025672932084615,1,2
5,0.125,150,150,0,0.0009377002716064453,0.0009968280792236328,1.0630561912026444,2,2
5,0.25,168,168,0,0.0013277530670166016,0.0011684894561767578,0.88005027832645,2,2
5,0.5,25,95,-70,0.003728628158569336,0.0012288093566894531,0.32956071360061384,1,2
5,0.75,15,15,0,0.03159618377685547,0.0012617111206054688,0.03993238960490175,2,2
6,0.125,78,78,0,0.0010025501251220703,0.0009922981262207031,0.9897740784780024,2,2
6,0.25,53,53,0,0.0017750263214111328,0.0012629032135009766,0.7114842175957018,3,3
6,0.5,41,41,0,0.031089067459106445,0.0013012886047363281,0.041856791183846255,2,2
6,0.75,46,46,0,0.7396948337554932,0.0016489028930664062,0.0022291664316415284,2,2
7,0.125,129,129,0,0.0012912750244140625,0.0013232231140136719,1.0247415066469718,3,3
7,0.25,69,69,0,0.0063250064849853516,0.0012295246124267578,0.1943910437634287,2,2
7,0.5,155,207,-52,0.33346056938171387,0.002152681350708008,0.00645557990469279,3,4
7,0.75,24,32,-8,16.24599027633667,0.0023200511932373047,0.0001428076192201474,3,4
8,0.125,24,286,-262,16.24599027633667,0.001833200454711914,0.00011284017923992534,3,4
8,0.25,24,108,-84,16.24599027633667,0.001931905746459961,0.00011891585022514176,3,4
8,0.5,24,67,-43,16.24599027633667,0.002154827117919922,0.00013263747431011122,3,3
8,0.75,24,64,-40,16.24599027633667,0.002978086471557617,0.00018331209245492358,3,4
9,0.125,24,151,-127,16.24599027633667,0.0016949176788330078,0.00010432836964711006,3,4
9,0.25,24,91,-67,16.24599027633667,0.001979827880859375,0.00012186563251506569,3,4
9,0.5,24,162,-138,16.24599027633667,0.0032634735107421875,0.00020087870639044064,3,5
9,0.75,24,70,-46,16.24599027633667,0.003774404525756836,0.00023232837528251504,3,5
10,0.125,24,123,-99,16.24599027633667,0.0018465518951416016,0.00011366200913164544,3,4
10,0.25,24,146,-122,16.24599027633667,0.00261688232421875,0.00016107865877713884,3,5
10,0.5,24,81,-57,16.24599027633667,0.003639698028564453,0.00022403669869641048,3,5
10,0.75,24,89,-65,16.24599027633667,0.004487276077270508,0.0002762082212868559,3,6
11,0.125,24,220,-196,16.24599027633667,0.002561330795288086,0.00015765925940623203,3,6
11,0.25,24,405,-381,16.24599027633667,0.003648042678833008,0.00022455034237873556,3,7
11,0.5,24,90,-66,16.24599027633667,0.0040280818939208984,0.0002479431432251969,3,5
11,0.75,24,120,-96,16.24599027633667,0.006203651428222656,0.00038185738897423036,3,6
12,0.125,24,172,-148,16.24599027633667,0.0026047229766845703,0.00016033020655432232,3,5
12,0.25,24,281,-257,16.24599027633667,0.0036966800689697266,0.0002275441512700016,3,7
12,0.5,24,77,-53,16.24599027633667,0.004682302474975586,0.00028821280791948157,3,6
12,0.75,24,229,-205,16.24599027633667,0.007452726364135742,0.0004587425104514015,3,8
13,0.125,24,261,-237,16.24599027633667,0.0028679370880126953,0.0001765319958482328,3,7
13,0.25,24,202,-178,16.24599027633667,0.0031409263610839844,0.0001933354820271526,3,6
13,0.5,24,237,-213,16.24599027633667,0.00675201416015625,0.0004156111166698772,3,8
13,0.75,24,118,-94,16.24599027633667,0.007910966873168945,0.0004869488863779377,3,7
14,0.125,24,313,-289,16.24599027633667,0.0036666393280029297,0.0002256950340136314,3,8
14,0.25,24,241,-217,16.24599027633667,0.004820823669433594,0.00029673929304607755,3,9
14,0.5,24,112,-88,16.24599027633667,0.007497310638427734,0.0004614868352683954,3,8
14,0.75,24,79,-55,16.24599027633667,0.007729053497314453,0.00047575145410325137,3,9
15,0.125,24,210,-186,16.24599027633667,0.003602743148803711,0.00022176199096039952,3,8
15,0.25,24,289,-265,16.24599027633667,0.00603795051574707,0.00037165789299663276,3,9
15,0.5,24,154,-130,16.24599027633667,0.008559942245483398,0.0005268956893290466,3,9
15,0.75,24,114,-90,16.24599027633667,0.011656761169433594,0.0007175161976067667,3,8
16,0.125,24,274,-250,16.24599027633667,0.003877878189086914,0.00023869755694334578,3,8
16,0.25,24,169,-145,16.24599027633667,0.003976106643676758,0.00024474387686100076,3,7
16,0.5,24,87,-63,16.24599027633667,0.008413076400756836,0.0005178555605201255,3,9
16,0.75,24,71,-47,16.24599027633667,0.010409355163574219,0.0006407338048660606,3,10
17,0.125,24,300,-276,16.24599027633667,0.004871845245361328,0.0002998798572751508,3,9
17,0.25,24,197,-173,16.24599027633667,0.00586700439453125,0.0003611355352758594,3,9
17,0.5,24,64,-40,16.24599027633667,0.007210731506347656,0.00044384684366397475,3,7
17,0.75,24,115,-91,16.24599027633667,0.012230873107910156,0.0007528548829507309,3,10
18,0.125,24,466,-442,16.24599027633667,0.004662990570068359,0.00028702408968324356,3,11
18,0.25,24,251,-227,16.24599027633667,0.006280660629272461,0.00038659758638540163,3,9
18,0.5,24,70,-46,16.24599027633667,0.008149385452270508,0.0005016244201586536,3,10
18,0.75,24,85,-61,16.24599027633667,0.011718511581420898,0.0007213171608559723,3,10
19,0.125,24,235,-211,16.24599027633667,0.0041446685791015625,0.000255119479243967,3,8
19,0.25,24,296,-272,16.24599027633667,0.00745081901550293,0.00045862510618115577,3,10
19,0.5,24,137,-113,16.24599027633667,0.012443304061889648,0.0007659307835493488,3,12
19,0.75,24,74,-50,16.24599027633667,0.01624321937561035,0.0009998294409464005,3,11
20,0.125,24,330,-306,16.24599027633667,0.005213499069213867,0.0003209098971829168,3,9
20,0.25,24,154,-130,16.24599027633667,0.007161855697631836,0.000440838359238928,3,11
20,0.5,24,98,-74,16.24599027633667,0.009388446807861328,0.0005778931692170347,3,11
20,0.75,24,210,-186,16.24599027633667,0.02039813995361328,0.0012555799681429384,3,13
21,0.125,24,307,-283,16.24599027633667,0.0045888423919677734,0.0002824599986774409,3,10
21,0.25,24,193,-169,16.24599027633667,0.008269786834716797,0.0005090355647179152,3,10
21,0.5,24,164,-140,16.24599027633667,0.020754098892211914,0.0012774905400775472,3,12
21,0.75,24,238,-214,16.24599027633667,0.026977062225341797,0.0016605366472880157,3,14
22,0.125,24,353,-329,16.24599027633667,0.006195783615112305,0.00038137309635946675,3,11
22,0.25,24,178,-154,16.24599027633667,0.009488344192504883,0.0005840422178711547,3,11
22,0.5,24,133,-109,16.24599027633667,0.019318819046020508,0.001189143826717637,3,14
22,0.75,24,48,-24,16.24599027633667,0.02186274528503418,0.0013457317721578767,3,12
23,0.125,24,271,-247,16.24599027633667,0.006840944290161133,0.00042108509077008424,3,13
23,0.25,24,364,-340,16.24599027633667,0.012105464935302734,0.0007451355521820743,3,13
23,0.5,24,286,-262,16.24599027633667,0.02386641502380371,0.001469064958051014,3,14
23,0.75,24,177,-153,16.24599027633667,0.03929471969604492,0.0024187334245349273,3,15
24,0.125,24,243,-219,16.24599027633667,0.00636744499206543,0.00039193948068158227,3,13
24,0.25,24,263,-239,16.24599027633667,0.013099908828735352,0.0008063472035814408,3,14
24,0.5,24,203,-179,16.24599027633667,0.015619277954101562,0.0009614235690422667,3,14
24,0.75,24,248,-224,16.24599027633667,0.044676780700683594,0.00275001892410081,3,14
25,0.125,24,444,-420,16.24599027633667,0.010533571243286133,0.0006483797579658137,3,13
25,0.25,24,495,-471,16.24599027633667,0.01917886734008789,0.0011805292883883566,3,18
25,0.5,24,211,-187,16.24599027633667,0.02923440933227539,0.0017994846011238348,3,16
25,0.75,24,156,-132,16.24599027633667,0.04849386215209961,0.0029849742199300733,3,15
26,0.125,24,358,-334,16.24599027633667,0.00839543342590332,0.0005167695710203526,3,11
26,0.25,24,177,-153,16.24599027633667,0.014228105545043945,0.0008757918294317889,3,13
26,0.5,24,219,-195,16.24599027633667,0.03679823875427246,0.0022650659103170497,3,16
26,0.75,24,172,-148,16.24599027633667,0.048270225524902344,0.002971208569243762,3,16
27,0.125,24,307,-283,16.24599027633667,0.008864402770996094,0.0005456363459670209,3,14
27,0.25,24,312,-288,16.24599027633667,0.015210628509521484,0.0009362697041421195,3,16
27,0.5,24,180,-156,16.24599027633667,0.02572798728942871,0.0015836515258108445,3,16
27,0.75,24,72,-48,16.24599027633667,0.04056906700134277,0.002497174152592854,3,16
28,0.125,24,212,-188,16.24599027633667,0.008305788040161133,0.0005112515703188034,3,13
28,0.25,24,367,-343,16.24599027633667,0.018242835998535156,0.0011229131427652657,3,16
28,0.5,24,341,-317,16.24599027633667,0.048095703125,0.002960466078516278,3,20
28,0.75,24,92,-68,16.24599027633667,0.04632973670959473,0.002851764399802514,3,18
29,0.125,24,578,-554,16.24599027633667,0.009888887405395508,0.0006086971146227576,3,15
29,0.25,24,321,-297,16.24599027633667,0.019436120986938477,0.0011963641893377491,3,15
29,0.5,24,143,-119,16.24599027633667,0.026627540588378906,0.001639022314765486,3,17
29,0.75,24,59,-35,16.24599027633667,0.027516603469848633,0.001693747380233776,3,18
30,0.125,24,404,-380,16.24599027633667,0.01098775863647461,0.0006763366498180776,3,17
30,0.25,24,328,-304,16.24599027633667,0.013596773147583008,0.0008369310159804529,3,20
30,0.5,24,213,-189,16.24599027633667,0.0385432243347168,0.00237247614205811,3,18
30,0.75,24,131,-107,16.24599027633667,0.06995463371276855,0.004305963042133663,3,20
31,0.125,24,415,-391,16.24599027633667,0.009054422378540039,0.0005573327463902516,3,15
31,0.25,24,282,-258,16.24599027633667,0.018477678298950195,0.0011373685435392708,3,19
31,0.5,24,165,-141,16.24599027633667,0.04767775535583496,0.0029347398677986828,3,20
31,0.75,24,107,-83,16.24599027633667,0.049800872802734375,0.0030654254961159587,3,19
32,0.125,24,578,-554,16.24599027633667,0.016145944595336914,0.0009938418231638683,3,18
32,0.25,24,340,-316,16.24599027633667,0.031107664108276367,0.0019147902700389205,3,20
32,0.5,24,196,-172,16.24599027633667,0.03561806678771973,0.002192422018102506,3,21
32,0.75,24,78,-54,16.24599027633667,0.05869174003601074,0.003612690826332639,3,19
33,0.125,24,598,-574,16.24599027633667,0.015445709228515625,0.0009507397804499055,3,18
33,0.25,24,299,-275,16.24599027633667,0.0313878059387207,0.0019320340222312618,3,19
33,0.5,24,154,-130,16.24599027633667,0.062026023864746094,0.003817928166255952,3,21
33,0.75,24,174,-150,16.24599027633667,0.06518149375915527,0.004012158855843728,3,21
34,0.125,24,471,-447,16.24599027633667,0.01578497886657715,0.0009716230650198644,3,19
34,0.25,24,217,-193,16.24599027633667,0.018488645553588867,0.0011380436180931839,3,18
34,0.5,24,139,-115,16.24599027633667,0.06111550331115723,0.0037618823027473977,3,21
34,0.75,24,120,-96,16.24599027633667,0.052629947662353516,0.0032395653799579347,3,19
35,0.125,24,700,-676,16.24599027633667,0.02050495147705078,0.0012621546072766991,3,22
35,0.25,24,227,-203,16.24599027633667,0.02601790428161621,0.0016014969748881951,3,19
35,0.5,24,258,-234,16.24599027633667,0.0701301097869873,0.00431676423499627,3,22
35,0.75,24,97,-73,16.24599027633667,0.09051680564880371,0.005571639777517734,3,22
36,0.125,24,367,-343,16.24599027633667,0.014655351638793945,0.000902090385966832,3,19
36,0.25,24,262,-238,16.24599027633667,0.028466463088989258,0.0017522147068161486,3,22
36,0.5,24,227,-203,16.24599027633667,0.05763101577758789,0.0035473993765422337,3,24
36,0.75,24,164,-140,16.24599027633667,0.10697293281555176,0.006584574470130314,3,23
37,0.125,24,392,-368,16.24599027633667,0.018285512924194336,0.0011255400633120138,3,21
37,0.25,24,337,-313,16.24599027633667,0.04328584671020508,0.002664401860024113,3,23
37,0.5,24,263,-239,16.24599027633667,0.06648731231689453,0.00409253675436071,3,24
37,0.75,24,170,-146,16.24599027633667,0.12598323822021484,0.007754728156135704,3,24
38,0.125,24,287,-263,16.24599027633667,0.013840675354003906,0.0008519440870381254,3,20
38,0.25,24,258,-234,16.24599027633667,0.039459228515625,0.0024288595428436214,3,22
38,0.5,24,213,-189,16.24599027633667,0.07344365119934082,0.004520724803480661,3,24
38,0.75,24,141,-117,16.24599027633667,0.12834429740905762,0.007900059967166135,3,25
39,0.125,24,297,-273,16.24599027633667,0.018584012985229492,0.0011439138316054701,3,21
39,0.25,24,315,-291,16.24599027633667,0.043829917907714844,0.002697891428111707,3,23
39,0.5,24,241,-217,16.24599027633667,0.10393762588500977,0.006397740249568018,3,25
39,0.75,24,145,-121,16.24599027633667,0.08614444732666016,0.005302505163513183,3,24
40,0.125,24,418,-394,16.24599027633667,0.01752471923828125,0.0010787104350177491,3,21
40,0.25,24,296,-272,16.24599027633667,0.05918431282043457,0.0036430104791235983,3,26
40,0.5,24,323,-299,16.24599027633667,0.1291944980621338,0.007952392920628168,3,25
40,0.75,24,84,-60,16.24599027633667,0.08358478546142578,0.0051449486328434164,3,22
41,0.125,24,644,-620,16.24599027633667,0.029026031494140625,0.001786658184599489,3,23
41,0.25,24,380,-356,16.24599027633667,0.05128073692321777,0.003156516534292863,3,25
41,0.5,24,257,-233,16.24599027633667,0.0815281867980957,0.00501835747845096,3,25
41,0.75,24,125,-101,16.24599027633667,0.15118813514709473,0.009306181560831657,3,27
42,0.125,24,381,-357,16.24599027633667,0.02684473991394043,0.0016523917260397184,3,23
42,0.25,24,412,-388,16.24599027633667,0.0594477653503418,0.0036592269439512893,3,29
42,0.5,24,190,-166,16.24599027633667,0.10353541374206543,0.00637298262407995,3,25
42,0.75,24,106,-82,16.24599027633667,0.11414575576782227,0.0070260879039231545,3,25
43,0.125,24,644,-620,16.24599027633667,0.02972126007080078,0.0018294520411040569,3,23
43,0.25,24,333,-309,16.24599027633667,0.07610130310058594,0.004684312978534303,3,28
43,0.5,24,270,-246,16.24599027633667,0.14861202239990234,0.009147612418331022,3,27
43,0.75,24,185,-161,16.24599027633667,0.14516258239746094,0.008935286795591623,3,27
44,0.125,24,679,-655,16.24599027633667,0.03702664375305176,0.002279125071678976,3,26
44,0.25,24,249,-225,16.24599027633667,0.056388139724731445,0.003470895818943361,3,26
44,0.5,24,276,-252,16.24599027633667,0.1100161075592041,0.006771892983307373,3,27
44,0.75,24,150,-126,16.24599027633667,0.18563294410705566,0.01142638527719926,3,29
45,0.125,24,397,-373,16.24599027633667,0.03200864791870117,0.001970249112196246,3,26
45,0.25,24,407,-383,16.24599027633667,0.0518183708190918,0.0031896098629683772,3,29
45,0.5,24,205,-181,16.24599027633667,0.10474848747253418,0.006447651739956234,3,29
45,0.75,24,118,-94,16.24599027633667,0.11935019493103027,0.007346440130822404,3,28
46,0.125,24,712,-688,16.24599027633667,0.034172773361206055,0.0021034589323238053,3,25
46,0.25,24,367,-343,16.24599027633667,0.06801819801330566,0.004186768356766688,3,29
46,0.5,24,167,-143,16.24599027633667,0.18267321586608887,0.011244203200845451,3,32
46,0.75,24,172,-148,16.24599027633667,0.15709733963012695,0.009669914665586704,3,28
47,0.125,24,457,-433,16.24599027633667,0.03093409538269043,0.001904106481446559,3,29
47,0.25,24,344,-320,16.24599027633667,0.07196640968322754,0.0044297951961753445,3,30
47,0.5,24,165,-141,16.24599027633667,0.14429688453674316,0.008881999932433842,3,28
47,0.75,24,184,-160,16.24599027633667,0.2591109275817871,0.015949223357544343,3,31
48,0.125,24,652,-628,16.24599027633667,0.02480316162109375,0.0015267251302754472,3,29
48,0.25,24,332,-308,16.24599027633667,0.05966758728027344,0.0036727577860971097,3,29
48,0.5,24,182,-158,16.24599027633667,0.14439177513122559,0.008887840794878567,3,31
48,0.75,24,169,-145,16.24599027633667,0.21204328536987305,0.013052038180690513,3,29
49,0.125,24,968,-944,16.24599027633667,0.061626434326171875,0.003793331971639472,3,32
49,0.25,24,276,-252,16.24599027633667,0.07825422286987305,0.004816833048574168,3,28
49,0.5,24,279,-255,16.24599027633667,0.15913748741149902,0.009795493208148291,3,32
49,0.75,24,222,-198,16.24599027633667,0.3036487102508545,0.018690686445450997,3,34
50,0.125,24,766,-742,16.24599027633667,0.054506778717041016,0.003355091181879731,3,33
50,0.25,24,656,-632,16.24599027633667,0.1164255142211914,0.007166415357934361,3,34
50,0.5,24,208,-184,16.24599027633667,0.1293501853942871,0.007961976044186976,3,31
50,0.75,24,147,-123,16.24599027633667,0.18697595596313477,0.011509052558986033,3,31
51,0.125,24,451,-427,16.24599027633667,0.03667616844177246,0.0022575520370213234,3,30
51,0.25,24,279,-255,16.24599027633667,0.06305360794067383,0.0038811797168508385,3,29
51,0.5,24,197,-173,16.24599027633667,0.20351862907409668,0.012527314470361013,3,36
51,0.75,24,255,-231,16.24599027633667,0.3379859924316406,0.020804271496083496,3,35
52,0.125,24,422,-398,16.24599027633667,0.04921531677246094,0.00302938238515052,3,30
52,0.25,24,345,-321,16.24599027633667,0.09552788734436035,0.0058800901465208225,3,30
52,0.5,24,241,-217,16.24599027633667,0.1902000904083252,0.011707509802302656,3,33
52,0.75,24,119,-95,16.24599027633667,0.18332481384277344,0.011284311434668149,3,31
53,0.125,24,564,-540,16.24599027633667,0.04474449157714844,0.0027541867756945334,3,29
53,0.25,24,263,-239,16.24599027633667,0.08103466033935547,0.004987979123524878,3,31
53,0.5,24,192,-168,16.24599027633667,0.1561415195465088,0.009611080450659814,3,35
53,0.75,24,178,-154,16.24599027633667,0.1935715675354004,0.01191503652549576,3,34
54,0.125,24,647,-623,16.24599027633667,0.03975796699523926,0.0024472479866708583,3,34
54,0.25,24,275,-251,16.24599027633667,0.09607386589050293,0.005913697118878662,3,30
54,0.5,24,247,-223,16.24599027633667,0.2270207405090332,0.013973955212795094,3,33
54,0.75,24,218,-194,16.24599027633667,0.359724760055542,0.0221423719906754,3,35
55,0.125,24,610,-586,16.24599027633667,0.06705141067504883,0.004127259067285884,3,36
55,0.25,24,384,-360,16.24599027633667,0.13617587089538574,0.008382121900795094,3,33
55,0.5,24,294,-270,16.24599027633667,0.3072795867919922,0.01891418014939752,3,39
55,0.75,24,170,-146,16.24599027633667,0.29467296600341797,0.01813819662520838,3,36
56,0.125,24,406,-382,16.24599027633667,0.04459977149963379,0.002745278726689639,3,31
56,0.25,24,431,-407,16.24599027633667,0.11000370979309082,0.006771129855550776,3,37
56,0.5,24,205,-181,16.24599027633667,0.20546817779541016,0.012647316310085928,3,36
56,0.75,24,246,-222,16.24599027633667,0.47731685638427734,0.029380594735398804,3,38
57,0.125,24,605,-581,16.24599027633667,0.05272984504699707,0.0032457144286120545,3,32
57,0.25,24,397,-373,16.24599027633667,0.13410162925720215,0.008254444756902865,3,34
57,0.5,24,232,-208,16.24599027633667,0.2547178268432617,0.01567881197210087,3,35
57,0.75,24,247,-223,16.24599027633667,0.3329896926879883,0.020496731010174813,3,38
58,0.125,24,707,-683,16.24599027633667,0.06864285469055176,0.004225218255272164,3,35
58,0.25,24,357,-333,16.24599027633667,0.13020610809326172,0.008014661210459746,3,39
58,0.5,24,162,-138,16.24599027633667,0.15881896018981934,0.009775886695017255,3,35
58,0.75,24,177,-153,16.24599027633667,0.3324868679046631,0.020465780309431282,3,39
59,0.125,24,490,-466,16.24599027633667,0.06790328025817871,0.004179694749484383,3,33
59,0.25,24,423,-399,16.24599027633667,0.13866639137268066,0.008535422526668453,3,37
59,0.5,24,305,-281,16.24599027633667,0.27983546257019043,0.017224894131433084,3,43
59,0.75,24,333,-309,16.24599027633667,0.5162785053253174,0.03177882643924207,3,38
60,0.125,24,701,-677,16.24599027633667,0.09808897972106934,0.006037734730393274,3,36
60,0.25,24,298,-274,16.24599027633667,0.10271978378295898,0.006322777623016121,3,35
60,0.5,24,181,-157,16.24599027633667,0.15217256546020508,0.009366776839812234,3,37
60,0.75,24,161,-137,16.24599027633667,0.44949769973754883,0.0276682241027973,3,39
61,0.125,24,417,-393,16.24599027633667,0.06760740280151367,0.004161482412062514,3,34
61,0.25,24,428,-404,16.24599027633667,0.13484811782836914,0.008300393853170286,3,42
61,0.5,24,228,-204,16.24599027633667,0.33461642265319824,0.020596862177160637,3,37
61,0.75,24,213,-189,16.24599027633667,0.5268876552581787,0.032431858341416375,3,40
62,0.125,24,494,-470,16.24599027633667,0.06910109519958496,0.0042534246311987,3,37
62,0.25,24,568,-544,16.24599027633667,0.21121668815612793,0.013001158105072772,3,41
62,0.5,24,355,-331,16.24599027633667,0.532233715057373,0.03276092783538137,3,40
62,0.75,24,151,-127,16.24599027633667,0.366788387298584,0.022577164029996672,3,38
63,0.125,24,728,-704,16.24599027633667,0.08197355270385742,0.005045771375553338,3,37
63,0.25,24,268,-244,16.24599027633667,0.20140337944030762,0.012397113134658501,3,40
63,0.5,24,177,-153,16.24599027633667,0.22788310050964355,0.014027036618479942,3,37
63,0.75,24,181,-157,16.24599027633667,0.3690462112426758,0.022716141334900054,3,38
64,0.125,24,668,-644,16.24599027633667,0.07854914665222168,0.0048349866838609135,3,37
64,0.25,24,280,-256,16.24599027633667,0.14537858963012695,0.00894858282919695,3,41
64,0.5,24,304,-280,16.24599027633667,0.43317508697509766,0.026663507709101922,3,42
64,0.75,24,225,-201,16.24599027633667,0.3732473850250244,0.02297473891565005,3,43
65,0.125,24,518,-494,16.24599027633667,0.08354067802429199,0.005142233659093984,3,39
65,0.25,24,383,-359,16.24599027633667,0.19668984413146973,0.012106977831813746,3,40
65,0.5,24,263,-239,16.24599027633667,0.4031391143798828,0.02481468396340732,3,42
65,0.75,24,164,-140,16.24599027633667,0.7323741912841797,0.04508030466760342,3,42
66,0.125,24,921,-897,16.24599027633667,0.12447428703308105,0.007661846702837553,3,41
66,0.25,24,366,-342,16.24599027633667,0.1892385482788086,0.011648323374565029,3,40
66,0.5,24,302,-278,16.24599027633667,0.4673149585723877,0.02876494141776399,3,41
66,0.75,24,315,-291,16.24599027633667,0.9060981273651123,0.05577364703245591,3,42
67,0.125,24,873,-849,16.24599027633667,0.12222552299499512,0.007523427068217839,3,43
67,0.25,24,260,-236,16.24599027633667,0.1803417205810547,0.011100691156003829,3,42
67,0.5,24,264,-240,16.24599027633667,0.49445080757141113,0.03043525197054996,3,42
67,0.75,24,169,-145,16.24599027633667,0.6791074275970459,0.04180154093691719,3,45
68,0.125,24,682,-658,16.24599027633667,0.08403635025024414,0.0051727440938240925,3,42
68,0.25,24,260,-236,16.24599027633667,0.23877859115600586,0.014697693836724883,3,41
68,0.5,24,260,-236,16.24599027633667,0.5881083011627197,0.036200212554561066,3,46
68,0.75,24,170,-146,16.24599027633667,0.4550330638885498,0.028008945970584183,3,46
69,0.125,24,684,-660,16.24599027633667,0.10616517066955566,0.006534853761681248,3,43
69,0.25,24,395,-371,16.24599027633667,0.22245121002197266,0.013692683932353891,3,46
69,0.5,24,219,-195,16.24599027633667,0.29120469093322754,0.017924711635300305,3,46
69,0.75,24,141,-117,16.24599027633667,0.6216380596160889,0.03826409157227828,3,44
70,0.125,24,546,-522,16.24599027633667,0.09732842445373535,0.00599091977763279,3,41
70,0.25,24,547,-523,16.24599027633667,0.1865384578704834,0.011482122954498419,3,47
70,0.5,24,193,-169,16.24599027633667,0.3490567207336426,0.021485715231657262,3,42
70,0.75,24,206,-182,16.24599027633667,1.0057830810546875,0.061909619785977296,3,46
71,0.125,24,439,-415,16.24599027633667,0.0858614444732666,0.005285085304915473,3,40
71,0.25,24,424,-400,16.24599027633667,0.28395724296569824,0.0174786047594341,3,44
71,0.5,24,232,-208,16.24599027633667,0.581942081451416,0.03582065922439041,3,45
71,0.75,24,233,-209,16.24599027633667,1.2578186988830566,0.07742333200304512,3,52
72,0.125,24,935,-911,16.24599027633667,0.19408559799194336,0.011946676976326984,3,49
72,0.25,24,409,-385,16.24599027633667,0.30919504165649414,0.019032083387791793,3,46
72,0.5,24,260,-236,16.24599027633667,0.5182106494903564,0.031897756965000995,3,46
72,0.75,24,198,-174,16.24599027633667,0.7950656414031982,0.04893919224864134,3,49
73,0.125,24,803,-779,16.24599027633667,0.15661883354187012,0.009640460869288808,3,47
73,0.25,24,536,-512,16.24599027633667,0.3568105697631836,0.02196299294127371,3,46
73,0.5,24,271,-247,16.24599027633667,0.37166786193847656,0.022877513504352808,3,49
73,0.75,24,194,-170,16.24599027633667,0.6498849391937256,0.04000279011248239,3,47
74,0.125,24,589,-565,16.24599027633667,0.1275787353515625,0.007852936828196256,3,44
74,0.25,24,364,-340,16.24599027633667,0.21102499961853027,0.012989358975913076,3,44
74,0.5,24,277,-253,16.24599027633667,0.401411771774292,0.024708359721166032,3,48
74,0.75,24,134,-110,16.24599027633667,0.6225731372833252,0.03832164901576625,3,46
75,0.125,24,1021,-997,16.24599027633667,0.21685147285461426,0.013347999670446213,3,50
75,0.25,24,315,-291,16.24599027633667,0.2151811122894287,0.013245182880778517,3,44
75,0.5,24,211,-187,16.24599027633667,0.3245968818664551,0.019980122870026047,3,50
75,0.75,24,138,-114,16.24599027633667,0.6990480422973633,0.043028958555734936,3,47
76,0.125,24,586,-562,16.24599027633667,0.11623978614807129,0.0071549831171191835,3,45
76,0.25,24,412,-388,16.24599027633667,0.3314323425292969,0.020400870423519176,3,46
76,0.5,24,200,-176,16.24599027633667,0.6206040382385254,0.03820044378227132,3,50
76,0.75,24,211,-187,16.24599027633667,1.1055729389190674,0.0680520497743622,3,48
77,0.125,24,715,-691,16.24599027633667,0.16672873497009277,0.010262762203726288,3,48
77,0.25,24,519,-495,16.24599027633667,0.5171627998352051,0.03183325799403475,3,53
77,0.5,24,251,-227,16.24599027633667,0.8223476409912109,0.0506184989036349,3,48
77,0.75,24,133,-109,16.24599027633667,0.6847262382507324,0.04214739924152732,3,46
78,0.125,24,730,-706,16.24599027633667,0.18165040016174316,0.01118124516092618,3,51
78,0.25,24,344,-320,16.24599027633667,0.26231980323791504,0.016146741366699,3,48
78,0.5,24,207,-183,16.24599027633667,0.6527307033538818,0.04017795728368902,3,48
78,0.75,24,152,-128,16.24599027633667,1.3564903736114502,0.08349693373799846,3,50
79,0.125,24,568,-544,16.24599027633667,0.16376996040344238,0.010080638829507603,3,44
79,0.25,24,397,-373,16.24599027633667,0.3055238723754883,0.01880610951863633,3,50
79,0.5,24,224,-200,16.24599027633667,0.9152486324310303,0.05633689401895979,3,48
79,0.75,24,265,-241,16.24599027633667,1.915846586227417,0.11792735029627407,3,55
80,0.125,24,660,-636,16.24599027633667,0.07257699966430664,0.004467379238187758,3,49
80,0.25,24,334,-310,16.24599027633667,0.3327324390411377,0.02048089610922542,3,48
80,0.5,24,253,-229,16.24599027633667,0.9130184650421143,0.056199619075974976,3,51
80,0.75,24,153,-129,16.24599027633667,1.4041433334350586,0.08643014735028395,3,54
81,0.125,24,1051,-1027,16.24599027633667,0.23940253257751465,0.014736099708629017,3,50
81,0.25,24,524,-500,16.24599027633667,0.33808469772338867,0.020810347167068713,3,53
81,0.5,24,256,-232,16.24599027633667,0.5448997020721436,0.0335405655674819,3,52
81,0.75,24,221,-197,16.24599027633667,0.9572741985321045,0.05892372100741904,3,55
82,0.125,24,533,-509,16.24599027633667,0.11612653732299805,0.007148012238573343,3,46
82,0.25,24,417,-393,16.24599027633667,0.5651335716247559,0.03478603409284993,3,51
82,0.5,24,289,-265,16.24599027633667,0.9779829978942871,0.06019842319607825,3,53
82,0.75,24,182,-158,16.24599027633667,1.1960625648498535,0.07362201654102893,3,51
83,0.125,24,587,-563,16.24599027633667,0.1587681770324707,0.009772760806321962,3,50
83,0.25,24,465,-441,16.24599027633667,0.26619553565979004,0.01638530684383832,3,57
83,0.5,24,209,-185,16.24599027633667,0.5653488636016846,0.034799286099853916,3,55
83,0.75,24,181,-157,16.24599027633667,1.6030597686767578,0.0986741799920758,3,54
84,0.125,24,529,-505,16.24599027633667,0.06529784202575684,0.004019320516328718,3,48
84,0.25,24,363,-339,16.24599027633667,0.18135595321655273,0.011163120876706996,3,52
84,0.5,24,216,-192,16.24599027633667,0.6759283542633057,0.04160585736948512,3,54
84,0.75,24,175,-151,16.24599027633667,1.535963535308838,0.09454416192443914,3,52
85,0.125,24,640,-616,16.24599027633667,0.2816746234893799,0.017338101199017526,3,54
85,0.25,24,486,-462,16.24599027633667,0.3117544651031494,0.01918962524292778,3,52
85,0.5,24,238,-214,16.24599027633667,0.520045280456543,0.03201068519744361,3,56
85,0.75,24,207,-183,16.24599027633667,1.2183303833007812,0.07499268204508025,3,56
86,0.125,24,945,-921,16.24599027633667,0.24462080001831055,0.015057303116487548,3,58
86,0.25,24,516,-492,16.24599027633667,0.4340369701385498,0.02671655976371921,3,53
86,0.5,24,328,-304,16.24599027633667,0.8879349231719971,0.05465563551797341,3,56
86,0.75,24,181,-157,16.24599027633667,1.96943998336792,0.12122621950823989,3,60
87,0.125,24,526,-502,16.24599027633667,0.19121718406677246,0.011770115629411191,3,49
87,0.25,24,611,-587,16.24599027633667,0.6838486194610596,0.042093378601680505,3,57
87,0.5,24,243,-219,16.24599027633667,0.9726674556732178,0.05987123217043719,3,55
87,0.75,24,178,-154,16.24599027633667,1.758436918258667,0.10823821068143463,3,57
88,0.125,24,715,-691,16.24599027633667,0.2808105945587158,0.01728491706459621,3,52
88,0.25,24,515,-491,16.24599027633667,0.5636849403381348,0.0346968655495983,3,56
88,0.5,24,265,-241,16.24599027633667,0.9890432357788086,0.06087922120816567,3,60
88,0.75,24,201,-177,16.24599027633667,1.628800392150879,0.10025860932117703,3,57
89,0.125,24,571,-547,16.24599027633667,0.17887043952941895,0.011010128437043031,3,53
89,0.25,24,434,-410,16.24599027633667,0.44574642181396484,0.027437319254291517,3,58
89,0.5,24,250,-226,16.24599027633667,0.9532303810119629,0.05867480927896432,3,59
89,0.75,24,255,-231,16.24599027633667,1.633141279220581,0.10052580676472252,3,54
90,0.125,24,669,-645,16.24599027633667,0.3148674964904785,0.01938124368750259,3,56
90,0.25,24,365,-341,16.24599027633667,0.3390531539916992,0.02086995918528598,3,52
90,0.5,24,318,-294,16.24599027633667,0.8994081020355225,0.05536185155456902,3,63
90,0.75,24,164,-140,16.24599027633667,1.5773882865905762,0.09709400656777098,3,58
91,0.125,24,663,-639,16.24599027633667,0.17872309684753418,0.011001058957166548,3,56
91,0.25,24,403,-379,16.24599027633667,0.6662654876708984,0.04101107266088648,3,58
91,0.5,24,247,-223,16.24599027633667,1.114546775817871,0.06860442219033457,3,57
91,0.75,24,194,-170,16.24599027633667,1.4706213474273682,0.09052211175882721,3,57
92,0.125,24,669,-645,16.24599027633667,0.2774946689605713,0.017080809740774014,3,52
92,0.25,24,674,-650,16.24599027633667,0.685570478439331,0.04219936530664484,3,59
92,0.5,24,255,-231,16.24599027633667,1.1315510272979736,0.06965109593510901,3,58
92,0.75,24,213,-189,16.24599027633667,1.2682034969329834,0.07806255422793176,3,59
93,0.125,24,773,-749,16.24599027633667,0.27638959884643555,0.017012788641700395,3,64
93,0.25,24,511,-487,16.24599027633667,0.8479108810424805,0.05219200963560327,3,60
93,0.5,24,295,-271,16.24599027633667,1.132176160812378,0.06968957518468205,3,58
93,0.75,24,216,-192,16.24599027633667,2.411163330078125,0.1484159038055156,3,58
94,0.125,24,768,-744,16.24599027633667,0.30707478523254395,0.018901573865879887,3,60
94,0.25,24,518,-494,16.24599027633667,0.4893317222595215,0.030120153584744208,3,62
94,0.5,24,206,-182,16.24599027633667,0.8898210525512695,0.05477173366571265,3,61
94,0.75,24,269,-245,16.24599027633667,2.936479091644287,0.1807510063527157,3,61
95,0.125,24,458,-434,16.24599027633667,0.25368261337280273,0.015615090804425002,3,55
95,0.25,24,404,-380,16.24599027633667,0.4540250301361084,0.027946897813759315,3,59
95,0.5,24,187,-163,16.24599027633667,0.7079720497131348,0.043578263785147134,3,59
95,0.75,24,231,-207,16.24599027633667,1.80726957321167,0.11124403883486711,3,61
96,0.125,24,621,-597,16.24599027633667,0.3205883502960205,0.01973338312057087,3,58
96,0.25,24,471,-447,16.24599027633667,0.6672506332397461,0.0410717119664684,3,56
96,0.5,24,248,-224,16.24599027633667,0.9804215431213379,0.06034852455558742,3,60
96,0.75,24,255,-231,16.24599027633667,1.8986308574676514,0.11686765935303614,3,60
97,0.125,24,720,-696,16.24599027633667,0.3323078155517578,0.020454758983561964,3,60
97,0.25,24,450,-426,16.24599027633667,0.9583978652954102,0.05899288679812755,3,64
97,0.5,24,315,-291,16.24599027633667,1.2467734813690186,0.07674345854958589,3,61
97,0.75,24,148,-124,16.24599027633667,1.6821463108062744,0.10354224532907845,3,60
98,0.125,24,610,-586,16.24599027633667,0.30614256858825684,0.018844192528797286,3,65
98,0.25,24,435,-411,16.24599027633667,0.5258262157440186,0.03236652286502462,3,67
98,0.5,24,292,-268,16.24599027633667,1.1737186908721924,0.07224666954170157,3,63
98,0.75,24,309,-285,16.24599027633667,2.368474245071411,0.14578823480654463,3,62
99,0.125,24,772,-748,16.24599027633667,0.1231377124786377,0.007579575660462859,3,63
99,0.25,24,504,-480,16.24599027633667,0.5628554821014404,0.03464580936757519,3,65
99,0.5,24,250,-226,16.24599027633667,0.897554874420166,0.05524777863049152,3,64
99,0.75,24,230,-206,16.24599027633667,1.713167667388916,0.10545172305588875,3,63
100,0.125,24,1094,-1070,16.24599027633667,0.5074033737182617,0.03123252969425492,3,66
100,0.25,24,435,-411,16.24599027633667,0.8059737682342529,0.04961062727017666,3,60
100,0.5,24,317,-293,16.24599027633667,1.6548326015472412,0.10186098682809205,3,64
100,0.75,24,237,-213,16.24599027633667,2.670715093612671,0.16439226222502049,3,67
101,0.125,24,702,-678,16.24599027633667,0.34806346893310547,0.0214245769579268,3,63
101,0.25,24,396,-372,16.24599027633667,0.8481388092041016,0.052206039445897634,3,64
101,0.5,24,361,-337,16.24599027633667,2.2619359493255615,0.13923041383449655,3,60
101,0.75,24,174,-150,16.24599027633667,3.0679471492767334,0.18884334516347678,3,65
102,0.125,24,599,-575,16.24599027633667,0.3514058589935303,0.02163031326599866,3,59
102,0.25,24,530,-506,16.24599027633667,0.6761555671691895,0.04161984315317814,3,67
102,0.5,24,231,-207,16.24599027633667,1.2765154838562012,0.07857418736212886,3,62
102,0.75,24,159,-135,16.24599027633667,2.4131686687469482,0.1485393397201452,3,63
103,0.125,24,638,-614,16.24599027633667,0.45352602005004883,0.027916181921556277,3,63
103,0.25,24,479,-455,16.24599027633667,0.9340522289276123,0.0574943240171773,3,68
103,0.5,24,214,-190,16.24599027633667,1.2865262031555176,0.07919038367451357,3,64
103,0.75,24,301,-277,16.24599027633667,3.1590020656585693,0.1944481076207376,3,63
104,0.125,24,728,-704,16.24599027633667,0.4274446964263916,0.026310781254682412,3,65
104,0.25,24,412,-388,16.24599027633667,0.37018370628356934,0.022786158306567852,3,64
104,0.5,24,294,-270,16.24599027633667,2.247361421585083,0.1383332984544814,3,67
104,0.75,24,171,-147,16.24599027633667,1.5252249240875244,0.0938831612074219,3,64
105,0.125,24,859,-835,16.24599027633667,0.3526027202606201,0.02170398444557785,3,66
105,0.25,24,407,-383,16.24599027633667,0.7266409397125244,0.04472740210677854,3,65
105,0.5,24,256,-232,16.24599027633667,1.8210930824279785,0.11209492628347302,3,70
105,0.75,24,191,-167,16.24599027633667,4.063420534133911,0.2501183655177084,3,63
106,0.125,24,782,-758,16.24599027633667,0.27614927291870117,0.016997995703649432,3,66
106,0.25,24,466,-442,16.24599027633667,0.4465775489807129,0.02748847816505109,3,66
106,0.5,24,368,-344,16.24599027633667,2.134549140930176,0.13138929081099376,3,74
106,0.75,24,177,-153,16.24599027633667,3.1928257942199707,0.19653008157160642,3,66
107,0.125,24,902,-878,16.24599027633667,0.5619595050811768,0.03459065871162726,3,68
107,0.25,24,486,-462,16.24599027633667,1.0863728523254395,0.06687021436346736,3,66
107,0.5,24,256,-232,16.24599027633667,2.0456926822662354,0.12591985145072496,3,68
107,0.75,24,194,-170,16.24599027633667,2.9890029430389404,0.18398404112014122,3,71
108,0.125,24,547,-523,16.24599027633667,0.26005125045776367,0.01600710366277549,3,68
108,0.25,24,350,-326,16.24599027633667,0.7287309169769287,0.044856047835900296,3,67
108,0.5,24,296,-272,16.24599027633667,2.165790319442749,0.1333122993799499,3,71
108,0.75,24,149,-125,16.24599027633667,2.0451812744140625,0.1258883724307653,3,69
109,0.125,24,685,-661,16.24599027633667,0.3446323871612549,0.021213381351288516,3,64
109,0.25,24,411,-387,16.24599027633667,0.6770074367523193,0.04167227883537664,3,67
109,0.5,24,283,-259,16.24599027633667,1.695451021194458,0.10436119881617752,3,68
109,0.75,24,187,-163,16.24599027633667,2.9616506099700928,0.18230040518268237,3,68
110,0.125,24,734,-710,16.24599027633667,0.3279285430908203,0.020185198779077772,3,64
110,0.25,24,398,-374,16.24599027633667,0.8362419605255127,0.05147374498577369,3,68
110,0.5,24,235,-211,16.24599027633667,0.9495580196380615,0.058448762032139945,3,71
110,0.75,24,241,-217,16.24599027633667,3.7050464153289795,0.22805913042590073,3,72
111,0.125,24,831,-807,16.24599027633667,0.4606313705444336,0.028353542179289176,3,70
111,0.25,24,439,-415,16.24599027633667,0.9195404052734375,0.05660106830254646,3,72
111,0.5,24,250,-226,16.24599027633667,2.5487101078033447,0.1568824100255498,3,71
111,0.75,24,281,-257,16.24599027633667,4.236218690872192,0.2607547227848903,3,70
112,0.125,24,832,-808,16.24599027633667,0.7165217399597168,0.04410452842652361,3,70
112,0.25,24,390,-366,16.24599027633667,0.5135729312896729,0.03161228848189851,3,70
112,0.5,24,320,-296,16.24599027633667,2.8287508487701416,0.1741199397915681,3,73
112,0.75,24,203,-179,16.24599027633667,2.2320268154144287,0.1373893974727733,3,72
113,0.125,24,864,-840,16.24599027633667,0.4659590721130371,0.028681481657153056,3,72
113,0.25,24,559,-535,16.24599027633667,1.2106618881225586,0.0745206581765573,3,72
113,0.5,24,279,-255,16.24599027633667,2.927682876586914,0.18020956720940998,3,75
113,0.75,24,158,-134,16.24599027633667,3.160728931427002,0.19455440251191133,3,69
114,0.125,24,936,-912,16.24599027633667,0.8506810665130615,0.052362524662601405,3,72
114,0.25,24,415,-391,16.24599027633667,1.3302233219146729,0.08188010083030942,3,69
114,0.5,24,306,-282,16.24599027633667,3.421351909637451,0.21059669810469298,3,70
114,0.75,24,219,-195,16.24599027633667,4.465252876281738,0.2748526128804636,3,73
115,0.125,24,914,-890,16.24599027633667,0.8702676296234131,0.053568149113754786,3,74
115,0.25,24,487,-463,16.24599027633667,1.1279828548431396,0.06943146189654682,3,72
115,0.5,24,300,-276,16.24599027633667,2.1746976375579834,0.13386057732199744,3,76
115,0.75,24,203,-179,16.24599027633667,5.1788530349731445,0.3187773073160383,3,74
116,0.125,24,894,-870,16.24599027633667,0.7306087017059326,0.04497163233995721,3,77
116,0.25,24,565,-541,16.24599027633667,1.3843517303466797,0.08521190194007915,3,75
116,0.5,24,247,-223,16.24599027633667,2.065397262573242,0.12713274029109978,3,71
116,0.75,24,147,-123,16.24599027633667,5.291558027267456,0.3257147109693246,3,72
117,0.125,24,795,-771,16.24599027633667,0.30044102668762207,0.018493241813965243,3,76
117,0.25,24,325,-301,16.24599027633667,1.0256402492523193,0.06313190096797179,3,71
117,0.5,24,279,-255,16.24599027633667,1.6611840724945068,0.10225194304801033,3,78
117,0.75,24,180,-156,16.24599027633667,3.6470236778259277,0.22448761914735677,3,72
118,0.125,24,810,-786,16.24599027633667,0.3040008544921875,0.018712362208845115,3,74
118,0.25,24,449,-425,16.24599027633667,0.790457010269165,0.04865551418066011,3,76
118,0.5,24,381,-357,16.24599027633667,4.458075761795044,0.27441083528706267,3,78
118,0.75,24,222,-198,16.24599027633667,3.7448360919952393,0.2305083302585644,3,76
119,0.125,24,922,-898,16.24599027633667,0.4988875389099121,0.030708348978675304,3,75
119,0.25,24,523,-499,16.24599027633667,1.859145164489746,0.11443717082594286,3,79
119,0.5,24,334,-310,16.24599027633667,2.7491185665130615,0.16921828215774137,3,75
119,0.75,24,233,-209,16.24599027633667,4.820215225219727,0.29670184108386916,3,73
120,0.125,24,872,-848,16.24599027633667,0.7077314853668213,0.04356345617156239,3,79
120,0.25,24,459,-435,16.24599027633667,1.9912097454071045,0.12256622782222329,3,75
120,0.5,24,288,-264,16.24599027633667,3.6136474609375,0.22243319117339433,3,80
120,0.75,24,225,-201,16.24599027633667,3.8926570415496826,0.23960724925581103,3,77
121,0.125,24,913,-889,16.24599027633667,0.8517861366271973,0.052430545761675024,3,79
121,0.25,24,527,-503,16.24599027633667,1.554295301437378,0.09567254904130461,3,82
121,0.5,24,343,-319,16.24599027633667,3.5830581188201904,0.2205503055137947,3,78
121,0.75,24,172,-148,16.24599027633667,3.3365530967712402,0.20537702165383814,3,73
122,0.125,24,760,-736,16.24599027633667,0.5284507274627686,0.03252807114088275,3,73
122,0.25,24,537,-513,16.24599027633667,1.173647165298462,0.07224226688156736,3,80
122,0.5,24,383,-359,16.24599027633667,3.567213535308838,0.21957501356532966,3,81
122,0.75,24,192,-168,16.24599027633667,5.4048261642456055,0.3326867782334009,3,76
123,0.125,24,672,-648,16.24599027633667,0.5340061187744141,0.03287002575350721,3,77
123,0.25,24,522,-498,16.24599027633667,1.7877683639526367,0.11004366822480723,3,84
123,0.5,24,267,-243,16.24599027633667,2.5778369903564453,0.15867527596093856,3,79
123,0.75,24,205,-181,16.24599027633667,3.6563122272491455,0.2250593632679197,3,79
124,0.125,24,1006,-982,16.24599027633667,0.9000139236450195,0.05539914208590582,3,80
124,0.25,24,624,-600,16.24599027633667,1.28519606590271,0.07910850887155095,3,83
124,0.5,24,235,-211,16.24599027633667,2.321502208709717,0.14289693451873686,3,76
124,0.75,24,210,-186,16.24599027633667,5.086458206176758,0.3130900683589299,3,80
125,0.125,24,646,-622,16.24599027633667,0.6417200565338135,0.03950021178262799,3,82
125,0.25,24,546,-522,16.24599027633667,1.5326013565063477,0.09433720754706348,3,81
125,0.5,24,322,-298,16.24599027633667,2.780700206756592,0.17116224738893637,3,84
125,0.75,24,238,-214,16.24599027633667,5.473134756088257,0.33689142139031253,3,80
126,0.125,24,846,-822,16.24599027633667,0.6569736003875732,0.040439123082850637,3,81
126,0.25,24,494,-470,16.24599027633667,1.02089524269104,0.06283982849466799,3,82
126,0.5,24,265,-241,16.24599027633667,2.5543878078460693,0.15723189318700379,3,84
126,0.75,24,211,-187,16.24599027633667,4.828216791152954,0.2971943666730838,3,83
127,0.125,24,894,-870,16.24599027633667,0.8921687602996826,0.05491624364685136,3,82
127,0.25,24,537,-513,16.24599027633667,2.167513608932495,0.1334183741381169,3,79
127,0.5,24,270,-246,16.24599027633667,2.574739456176758,0.1584846114260595,3,82
127,0.75,24,168,-144,16.24599027633667,3.107156991958618,0.1912568540979858,3,79
128,0.125,24,861,-837,16.24599027633667,0.5367870330810547,0.033041201179525484,3,82
128,0.25,24,551,-527,16.24599027633667,1.7234816551208496,0.10608658664724252,3,81
128,0.5,24,347,-323,16.24599027633667,3.4467570781707764,0.21216047895776471,3,85
128,0.75,24,271,-247,16.24599027633667,5.922636985778809,0.3645599243282517,3,84
129,0.125,24,1098,-1074,16.24599027633667,0.902252197265625,0.05553691599703918,3,85
129,0.25,24,389,-365,16.24599027633667,1.8825876712799072,0.11588014268493176,3,80
129,0.5,24,333,-309,16.24599027633667,3.5190155506134033,0.21660825168282144,3,81
129,0.75,24,215,-191,16.24599027633667,3.6964704990386963,0.22753125147580835,3,80
130,0.125,24,919,-895,16.24599027633667,0.8671138286590576,0.053374021152903475,3,83
130,0.25,24,524,-500,16.24599027633667,1.9402127265930176,0.11942717517312948,3,84
130,0.5,24,241,-217,16.24599027633667,2.7920656204223633,0.1718618300842631,3,83
130,0.75,24,228,-204,16.24599027633667,3.4359209537506104,0.21149347594743118,3,80
131,0.125,24,820,-796,16.24599027633667,0.6513979434967041,0.040095921049854814,3,84
131,0.25,24,521,-497,16.24599027633667,2.0920464992523193,0.12877309807943932,3,87
131,0.5,24,332,-308,16.24599027633667,4.501912832260132,0.2771091669811878,3,86
131,0.75,24,213,-189,16.24599027633667,4.126754283905029,0.25401678898675156,3,82
132,0.125,24,829,-805,16.24599027633667,1.019881248474121,0.0627774134494986,3,87
132,0.25,24,431,-407,16.24599027633667,2.2136404514312744,0.13625764965867204,3,80
132,0.5,24,305,-281,16.24599027633667,3.6276798248291016,0.22329693438959217,3,81
132,0.75,24,193,-169,16.24599027633667,4.749096870422363,0.2923242467613518,3,85
133,0.125,24,687,-663,16.24599027633667,1.197883129119873,0.07373407891697847,3,89
133,0.25,24,625,-601,16.24599027633667,1.9757251739501953,0.12161309592976713,3,88
133,0.5,24,329,-305,16.24599027633667,4.151527166366577,0.2555416503242368,3,87
133,0.75,24,198,-174,16.24599027633667,5.1613545417785645,0.3177002111897364,3,84
134,0.125,24,744,-720,16.24599027633667,0.7463278770446777,0.0459392049576536,3,83
134,0.25,24,530,-506,16.24599027633667,1.8099632263183594,0.11140984301552163,3,87
134,0.5,24,279,-255,16.24599027633667,4.658955812454224,0.2867757356250725,3,82
134,0.75,24,206,-182,16.24599027633667,7.099315404891968,0.43698877594630703,3,84
135,0.125,24,743,-719,16.24599027633667,0.7559278011322021,0.04653011532533413,3,88
135,0.25,24,610,-586,16.24599027633667,2.6295340061187744,0.16185741597721254,3,94
135,0.5,24,344,-320,16.24599027633667,2.6946287155151367,0.16586423293876007,3,86
135,0.75,24,246,-222,16.24599027633667,7.443115711212158,0.45815093968470083,3,85
136,0.125,24,734,-710,16.24599027633667,0.8479561805725098,0.052194797987021604,3,87
136,0.25,24,435,-411,16.24599027633667,1.449181079864502,0.08920238503252877,3,88
136,0.5,24,260,-236,16.24599027633667,2.7004213333129883,0.16622078970749635,3,86
136,0.75,24,230,-206,16.24599027633667,8.274068117141724,0.5092990932780156,3,84
137,0.125,24,863,-839,16.24599027633667,1.0821073055267334,0.06660765438859657,3,87
137,0.25,24,448,-424,16.24599027633667,2.0953352451324463,0.1289755323924105,3,89
137,0.5,24,327,-303,16.24599027633667,2.4162561893463135,0.14872938788260548,3,92
137,0.75,24,261,-237,16.24599027633667,9.82000732421875,0.6044572942113736,3,90
138,0.125,24,733,-709,16.24599027633667,0.6369421482086182,0.03920611408566244,3,88
138,0.25,24,395,-371,16.24599027633667,2.232361078262329,0.13740997257113385,3,84
138,0.5,24,277,-253,16.24599027633667,4.228519439697266,0.26028080577250967,3,89
138,0.75,24,181,-157,16.24599027633667,4.632554292678833,0.28515062571633115,3,86
139,0.125,24,1051,-1027,16.24599027633667,1.3258726596832275,0.08161230168987892,3,91
139,0.25,24,585,-561,16.24599027633667,2.544039726257324,0.15659493099431937,3,85
139,0.5,24,441,-417,16.24599027633667,6.125283241271973,0.377033541020509,3,94
139,0.75,24,198,-174,16.24599027633667,5.729099273681641,0.35264697172855275,3,84
140,0.125,24,823,-799,16.24599027633667,1.063096523284912,0.06543747135152361,3,89
140,0.25,24,520,-496,16.24599027633667,1.8044309616088867,0.1110693119296739,3,94
140,0.5,24,288,-264,16.24599027633667,6.148733615875244,0.3784769971721127,3,86
140,0.75,24,212,-188,16.24599027633667,8.362779378890991,0.5147595952382119,3,92
141,0.125,24,982,-958,16.24599027633667,1.503246784210205,0.09253032647691417,3,94
141,0.25,24,545,-521,16.24599027633667,1.9795358180999756,0.1218476549861843,3,92
141,0.5,24,389,-365,16.24599027633667,4.72067928314209,0.2905750405389607,3,96
141,0.75,24,213,-189,16.24599027633667,5.199433326721191,0.3200440993919897,3,90
142,0.125,24,878,-854,16.24599027633667,1.3226392269134521,0.08141327210074484,3,93
142,0.25,24,427,-403,16.24599027633667,1.2969462871551514,0.07983177787839976,3,89
142,0.5,24,252,-228,16.24599027633667,5.129633188247681,0.31574764609574596,3,90
142,0.75,24,272,-248,16.24599027633667,5.926488161087036,0.3647969782254116,3,91
143,0.125,24,851,-827,16.24599027633667,0.740795373916626,0.04559865919627209,3,92
143,0.25,24,489,-465,16.24599027633667,2.1925153732299805,0.1349573239880317,3,89
143,0.5,24,394,-370,16.24599027633667,7.227971315383911,0.4449080168361246,3,94
143,0.75,24,307,-283,16.24599027633667,7.24463963508606,0.44593401275380196,3,99
144,0.125,24,766,-742,16.24599027633667,1.5602660179138184,0.09604006843377508,3,93
144,0.25,24,549,-525,16.24599027633667,2.2435595989227295,0.13809928239281408,3,91
144,0.5,24,290,-266,16.24599027633667,5.035448312759399,0.3099502232310119,3,93
144,0.75,24,217,-193,16.24599027633667,9.169254064559937,0.5644010558048619,3,94
145,0.125,24,710,-686,16.24599027633667,1.0947189331054688,0.0673839460989951,3,90
145,0.25,24,511,-487,16.24599027633667,2.764697313308716,0.17017721088604093,3,95
145,0.5,24,286,-262,16.24599027633667,3.1370999813079834,0.1930999543855059,3,93
145,0.75,24,298,-274,16.24599027633667,7.27832555770874,0.44800750424614555,3,94
146,0.125,24,632,-608,16.24599027633667,0.8907032012939453,0.0548260331407013,3,89
146,0.25,24,514,-490,16.24599027633667,1.9259912967681885,0.11855179425864354,3,97
146,0.5,24,351,-327,16.24599027633667,4.767620325088501,0.293464433007377,3,94
146,0.75,24,194,-170,16.24599027633667,9.929640531539917,0.6112056182874291,3,90
147,0.125,24,916,-892,16.24599027633667,1.3514046669006348,0.08318388992692201,3,96
147,0.25,24,424,-400,16.24599027633667,1.4361381530761719,0.08839954528152091,3,87
147,0.5,24,313,-289,16.24599027633667,3.990558385848999,0.24563343434111887,3,96
147,0.75,24,243,-219,16.24599027633667,10.879971981048584,0.6697019877511537,3,98
148,0.125,24,688,-664,16.24599027633667,1.1188433170318604,0.06886888998459685,3,93
148,0.25,24,679,-655,16.24599027633667,2.3243110179901123,0.14306982698220747,3,96
148,0.5,24,286,-262,16.24599027633667,5.421320199966431,0.33370204633588463,3,94
148,0.75,24,216,-192,16.24599027633667,10.508133888244629,0.6468139959156816,3,91
149,0.125,24,842,-818,16.24599027633667,1.3088736534118652,0.08056595080684764,3,98
149,0.25,24,492,-468,16.24599027633667,2.060936212539673,0.1268581463785288,3,99
149,0.5,24,329,-305,16.24599027633667,7.319694519042969,0.45055391481457274,3,97
149,0.75,24,289,-265,16.24599027633667,11.402441024780273,0.7018618644250122,3,101
150,0.125,24,885,-861,16.24599027633667,1.179612159729004,0.0726094340612271,3,91
150,0.25,24,515,-491,16.24599027633667,3.582681655883789,0.22052713284595493,3,97
150,0.5,24,253,-229,16.24599027633667,4.5817461013793945,0.28202319608999166,3,95
150,0.75,24,219,-195,16.24599027633667,8.764132499694824,0.5394643447780679,3,100
